1111111111111
1000000000001
1000000000001
10CEP00000001
1111111111111